#############################################
#                                           #
#         ###########                       #
#                                           #
#                                           #
#                ##############             #
#                ##############             #
#                ##                         #
#                ##                 #       #
########         ##                 #       #
#      #         ##                 #       #
#      #         ##                         #
#      ###       ##############             #
#                ##############             #
#                                           #
#                                           #
#                                           #
#                #############              #
#                                           #
#############################################