#############################################
#                                           #
#       ###            ###                  #
#       ###            ###                  #
################  #####################     #
#                                           #
#                                           #
######  ##################  ##########      #
#                                           #
#                                           #
###############     ##                      #
#                   ##         ##############
#               ###########                 #
#                         #                 #
##############            #         #########
#               ###########                 #
#############                   #############
#                  ##########               #
#                                           #
#############################################